NO texture/walls1.xpm
SO texture/walls2.xpm
WE texture/walls3.xpm
EA texture/walls4.xpm

F 8,82,92
C 8,82,92

111111111111111111111111
100000000011000000000001
100111111011011110111101
101000000000000000000001
111111111011000001110001
100000000011000001110001
111100011111110111000001
100100011111110111000111
100000001000010111000001
111000001000000011111101
10000N000000000011000001
100000001111111110000001
100000001000000000000001
111111111111111111111111
