NO texture/walls1.xpm
SO texture/walls2.xpm
WE texture/walls3.xpm
EA texture/walls4.xpm

F 105,104,92
C 8,82,92


   1111111111111111111111
   1000000000110000000001
1111000001110000000000001
100100000000000000000000111111111
111111111011000001110000000000001
100000000011000001110111111111111
11110111111111011100000010001
11110111111111011101010010001
11000000110101011100000010001
10000W00000000001100000010001
10000000000000001101010010001
1100000111010101111101111000111
11110111 1110101 101111010001
11111111 1111111 111111111111