NO ./path_to_the_north_texture
SO ./path_to_the_south_texture
WE ./path_to_the_west_texture
EA ./path_to_the_east_texture

F 119,221,119
C 58,117,196


111111111111             11111111111111
1000010000011111        11000000000000111111111111
10S00100000000011       10000000000000000000000001
10000100000000001111111111111100000000000000000001    11111111111
11001111111110000010000000000100000000111110000001   110000000001
100000000000100000100000000001110000111   11000001  100001110001
100000000000100000000010000000000000001    1100001  10001   10001
111110000000000100000010000000000000001      1000111110001   10001
    10000000100111111111111111110000111     110000000000011110001
1111100000111000000000000000000000011     1110000000000000000001
100000000010000000000000000000000011     11000000011111000000001111
1000000000000001000001110001110000011   1100000001     100000000001
1000000000100001000001 10001 10000001  110000000001111100000000011
1111111111111111111111 11111 11111111  110000000000000000000000001
                                        11111111111111111111111111