NO ./path_to_the_north_texture
SO ./path_to_the_south_texture
WE ./path_to_the_west_texture
EA ./path_to_the_east_texture

F 119,221,119
C 58,117,196

1111111111111111111111111111111111111111111
100W000000000000000000000000000000000000001
1011111110111111111111111111111111111111101
1000000000100000000000000000000000000000101
1111111101110111111111111111111111111110101
1000000100000100000000000000000000000010101
1011111111111111111110111111111111111010101
1010000000000000000000100000000000001010101
1010111111111111111111111111111111101010101
1010100000000000000000000000000000101010101
1010101111111111111111111111111110101010101
1010101000000000000000000000000010101010101
1010101011111111111111111111111010101010101
1010101010000000000000000000001010101010101
1010101010111111111111111111101010101010101
1010101010000000000000000000101010101010101
1010101011111111111111111110101010101010101
1010101000000000000000000010101010101010101
1010101111111111111111111010101010101010101
1010100000000000000000000010101010101010101
1010111111111111111111111011111010101010101
1010000000000000000000000000000000101010101
1010111111111111111111111111111111101010101
1010000000000000000000000000000000001010101
1111111111111111111111111111111111111110101
1000000000000000000000000000000000000000101
1011111111111111111111111111111111111111101
1000000000000000000000000000000000000000001
1111111111111111111111111111111111111111111
