NO texture/walls1.xpm
SO texture/walls2.xpm
WE texture/walls3.xpm
EA texture/walls4.xpm

F 105,104,92
C 8,82,92

1111111111111111111111111111111111111111111
1000000000000000000000000000000000000000001
100W011110111111111111111111111100111111101
1000000000100000000000000000000000000000101
1111111101110111111111001111111111111110101
1000000100000100000000000000000000000010101
1011110011111111111110111111111001111010101
1010000000000000000000100000000000001010101
1010111100111111111111111111111111101010101
1010100000000000000000000000000000101010101
1010101111111100111111111111111110101010101
1010101000000000000000000000000010101010101
1010101011100111111111001111111010101010101
1010101010000000000000000010001010101010101
1010101010111100111111111111101010101010101
1010101010000000000000000000101010101010101
1010101011111111110011111110101010101010101
1010101000000000010000000010101010101010101
1010101111100110111110011010101010101010101
1010100000000010000000000010001010101010101
1010111111001111111111111011111010101010101
1010000000000000001000000000000000101010101
1010111110011001111111111111111111101010101
1010000000000000000000010000000000001010101
1111111110011111111111111111100111111110101
1000000000000000001000000001000000000000101
1011111110011111111110011111111100111111101
1000000000000000000000000000000000000000001
1111111111111111111111111111111111111111111
