NO ./path_to_the_north_texture
SO ./path_to_the_south_texture
WE ./path_to_the_west_texture
EA ./path_to_the_east_texture

F 119,221,119
C 58,117,196

111111111111111
100000E01000001
100000000000001
100000100000001
100000000000001
100000000000001
100000000000001
111111111111111

	
