NO ./path_to_the_north_texture
SO ./path_to_the_south_texture
WE ./path_to_the_west_texture
EA ./path_to_the_east_texture

F 119,221,119
C 58,117,196

              111111111111111
              100000000000001
              100000000000001
              100000000000001
              100000000000001
              100000000000001
              100000000000001
              111111101111111
                    101
             1111111101
            10000000001
          1100001111001
        110000001   101
        100000001   101
        1100000001  101
          1000001   101
           10001   1001
1111111111  101    1001    1111111111111
1000000001  101 11  101    1001000000001
1000000001111111001110111111001000000001
1000000000000000000000000000000000000001
1000000001110001111110111111111000000001
1000000001 10001    101       1000000001
1111111111 10001   1001       1111111111
           100001   1011
            100001  10001
            1000001 1011
           100000001101
          1000110000001
          10001 1000001
          10001  111101
           10001    1011
            1000111110001
            100000000011
            11111111101
                    101
              111111101111111
              100000000000001
              100000000000001
              100000000000001
              100000000000001
              100000000000001
              10000000000N001
              111111111111111

	
