EA texture/east_wall.xpm
NO texture/north_wall.xpm
SO texture/south_wall.xpm
WE texture/west_wall.xpm

F 105,104,92
C 8,82,92

              111111111111111
              100000000000001
              100000000000001
              100000000000001
              100000000000001
              100000000000001
              100000000000001
              111111101111111
                    101
             111111110111111111
            1000000000000000001
          110000111100000000001
        110000001   10111111001
        100000001   101    1001
        1100000001  101    1001
          1000001   101    1001
           10001   1001    1001
1111111111  101    1001    1001111111111
1000000001  101 11  101    1001000000001
1000000001111011001110111111000000000001
1000000000000000000000000000000000000001
1000000001110001111110111111111000000001
1000000001 10001    101       1000000001
1111111111 10001   1001       1111111111
           100001   1011
            100001  10001
            1000001 1011
           100000001101
          1000110000001
          10001 1000001
          10001  111101
           10001    1011
            1000111110001
            100000000011
            11111111101
                    101
              111111101111111
              100000000000001
              100000000000001
              100000S00000001
              100000000000001
              100000010000001
              100000001000001
              111111111111111
